1,2,3,1,2,3,1,2,3,1,2,3,1,2,3,1,2,3,1,2,3,1,2,3,1,2,3,1,2,3,1,2,3,1,2,3,1,2,3,1
4,5,6,4,5,6,4,5,6,4,5,6,4,5,6,4,5,6,4,5,6,4,5,6,4,5,6,4,5,6,4,5,6,4,5,6,4,5,6,4
1,8,9,1,8,9,1,8,9,1,8,9,1,8,9,1,8,9,1,8,9,1,8,9,1,8,9,1,8,9,1,8,9,1,8,9,1,8,9,1
1,2,3,1,2,3,1,2,3,1,2,3,1,2,3,1,2,3,1,2,3,1,2,3,1,2,3,1,2,3,1,2,3,1,2,3,1,2,3,1
4,5,6,4,5,6,4,5,6,4,5,6,4,5,6,4,5,6,4,5,6,4,5,6,4,5,6,4,5,6,4,5,6,4,5,6,4,5,6,4
1,8,9,1,8,9,1,8,9,1,8,9,1,8,9,1,8,9,1,8,9,1,8,9,1,8,9,1,8,9,1,8,9,1,8,9,1,8,9,1
1,2,3,1,2,3,1,2,3,1,2,3,1,2,3,1,2,3,1,2,3,1,2,3,1,2,3,1,2,3,1,2,3,1,2,3,1,2,3,1
4,5,6,4,5,6,4,5,6,4,5,6,4,5,6,4,5,6,4,5,6,4,5,6,4,5,6,4,5,6,4,5,6,4,5,6,4,5,6,4
1,8,9,1,8,9,1,8,9,1,8,9,1,8,9,1,8,9,1,8,9,1,8,9,1,8,9,1,8,9,1,8,9,1,8,9,1,8,9,1
1,2,3,1,2,3,1,2,3,1,2,3,1,2,3,1,2,3,1,2,3,1,2,3,1,2,3,1,2,3,1,2,3,1,2,3,1,2,3,1
4,5,6,4,5,6,4,5,6,4,5,6,4,5,6,4,5,6,4,5,6,4,5,6,4,5,6,4,5,6,4,5,6,4,5,6,4,5,6,4
1,8,9,1,8,9,1,8,9,1,8,9,1,8,9,1,8,9,1,8,9,1,8,9,1,8,9,1,8,9,1,8,9,1,8,9,1,8,9,1
1,2,3,1,2,3,1,2,3,1,2,3,1,2,3,1,2,3,1,2,3,1,2,3,1,2,3,1,2,3,1,2,3,1,2,3,1,2,3,1
4,5,6,4,5,6,4,5,6,4,5,6,4,5,6,4,5,6,4,5,6,4,5,6,4,5,6,4,5,6,4,5,6,4,5,6,4,5,6,4
1,8,9,1,8,9,1,8,9,1,8,9,1,8,9,1,8,9,1,8,9,1,8,9,1,8,9,1,8,9,1,8,9,1,8,9,1,8,9,1
1,2,3,1,2,3,1,2,3,1,2,3,1,2,3,1,2,3,1,2,3,1,2,3,1,2,3,1,2,3,1,2,3,1,2,3,1,2,3,1
4,5,6,4,5,6,4,5,6,4,5,6,4,5,6,4,5,6,4,5,6,4,5,6,4,5,6,4,5,6,4,5,6,4,5,6,4,5,6,4
1,8,9,1,8,9,1,8,9,1,8,9,1,8,9,1,8,9,1,8,9,1,8,9,1,8,9,1,8,9,1,8,9,1,8,9,1,8,9,1
1,2,3,1,2,3,1,2,3,1,2,3,1,2,3,1,2,3,1,2,3,1,2,3,1,2,3,1,2,3,1,2,3,1,2,3,1,2,3,1
4,5,6,4,5,6,4,5,6,4,5,6,4,5,6,4,5,6,4,5,6,4,5,6,4,5,6,4,5,6,4,5,6,4,5,6,4,5,6,4
1,8,9,1,8,9,1,8,9,1,8,9,1,8,9,1,8,9,1,8,9,1,8,9,1,8,9,1,8,9,1,8,9,1,8,9,1,8,9,1
1,2,3,1,2,3,1,2,3,1,2,3,1,2,3,1,2,3,1,2,3,1,2,3,1,2,3,1,2,3,1,2,3,1,2,3,1,2,3,1
4,5,6,4,5,6,4,5,6,4,5,6,4,5,6,4,5,6,4,5,6,4,5,6,4,5,6,4,5,6,4,5,6,4,5,6,4,5,6,4
